
 wwwwwwwwwwwwwwwwwwwwwwwwwwwwwwwwwwwwww
 ww    w         w    w         w     w
 w                                    w
 w                                    w
 w   www      www      www            w
 w   www      www      www            w
 w   www      www      www           ww
 w                                    w
 w                             wwwww  w
 w                             w   w  w
 w   www      www      www     w e w  w
 ww  www      www      www     w   w  w
 w   www      www      www     w   w  w
 w                                    w
 w                                    w
 w                                    w
 ww  www      www      www           ww
 w   www      www      www            w
 w   www      www      www            w
 w                                    w
 w                                   w
 w     w    w    s     w    w        ww
 wwwwwwwwwwwwwwwwwwwwwwwwwwwwwwwwwwwwww
